2-keto-3-deoxygluconate	SIMPLE_MOLECULE	2-DEHYDRO-3-DEOXY-D-GLUCONATE
D-glucoronoside	SIMPLE_MOLECULE	|Glucuronides|
D-glucoronoside_Ext	SIMPLE_MOLECULE	|Glucuronides|_Ext
ExuR	PROTEIN	PD03270
GntP	PROTEIN	GNTP-MONOMER
LgoR	PROTEIN	G7944-MONOMER
UidA	PROTEIN	BETA-GLUCURONID-MONOMER
UidB	PROTEIN	UIDB-MONOMER
UidC	PROTEIN	G6866-MONOMER
UxuA	PROTEIN	MANNONDEHYDRAT-MONOMER
UxuB	PROTEIN	MANNONOXIDOREDUCT-MONOMER
UxuR	PROTEIN
UxuR-alpha-D-galacturonate	COMPLEX
UxuR-alpha-D-glucuronate	COMPLEX
UxuR-fructuronate	COMPLEX
aldehydo-D-glucuronate	SIMPLE_MOLECULE
alcohol	SIMPLE_MOLECULE	|Alcohols|
alpha-D-galacturonate	SIMPLE_MOLECULE
alpha-D-glucuronate	SIMPLE_MOLECULE
exuR	GENE
exuR_mRNA	RNA
fructuronate	SIMPLE_MOLECULE
fructuronate	SIMPLE_MOLECULE	FRUCTURONATE
fructuronate_Ext	SIMPLE_MOLECULE	FRUCTURONATE_Ext
gluconate	SIMPLE_MOLECULE	GLUCONATE
gluconate_Ext	SIMPLE_MOLECULE	GLUCONATE_Ext
glucopyranuronate	SIMPLE_MOLECULE	|D-Glucopyranuronate|
glucuronide	SIMPLE_MOLECULE	|Beta-D-Glucuronides|
gntP	GENE
gntP_mRNA	RNA
lgoR	GENE
lgoR_mRNA	RNA
mannonate	SIMPLE_MOLECULE	D-MANNONATE
uidABC	GENE
uidABC_mRNA	RNA
uxuAB	GENE
uxuAB_mRNA	RNA
uxuR	GENE
uxuR_mRNA	RNA
