2-methylerylthritol 4-phosphate	SIMPLE_MOLECULE	2-C-METHYL-D-ERYTHRITOL-4-PHOSPHATE
CDP-ME	SIMPLE_MOLECULE	4-CYTIDINE-5-DIPHOSPHO-2-C
CDP-ME-2P	SIMPLE_MOLECULE	2-PHOSPHO-4-CYTIDINE-5-DIPHOSPHO-2-C-MET
CO2	SIMPLE_MOLECULE	CARBON-DIOXIDE
DMPP	SIMPLE_MOLECULE	CPD-4211
DOXP	SIMPLE_MOLECULE	DEOXYXYLULOSE-5P
Dxr	PROTEIN	DXPREDISOM-MONOMER
Dxs	PROTEIN	DXS-MONOMER
Fdx	PROTEIN	FERREDOXIN-MONOMER
FldA	PROTEIN	FLAVODOXIN1-MONOMER
FldA	SIMPLE_MOLECULE	|Oxidized-flavodoxins|
FldA	SIMPLE_MOLECULE	|Reduced-flavodoxins|
HMBDP	SIMPLE_MOLECULE	HYDROXY-METHYL-BUTENYL-DIP
Idi	PROTEIN	IPPISOM-MONOMER
IspD	PROTEIN	G7423-MONOMER
IspE	PROTEIN	EG11294-MONOMER
IspF	PROTEIN	EG11816-MONOMER
IspG	PROTEIN	EG10370-MONOMER
IspH	PROTEIN	EG11081-MONOMER
ME-2,4cPP	SIMPLE_MOLECULE	2C-METH-D-ERYTHRITOL-CYCLODIPHOSPHATE
NONMEVIPP-PWY	PROTEIN
cytidine-triphosphate	SIMPLE_MOLECULE	CTP
cytidylate	SIMPLE_MOLECULE	CMP
diphosphate	SIMPLE_MOLECULE	PPI
dxr	GENE
dxr_mRNA	RNA
dxs	GENE
dxs_mRNA	RNA
fdx	GENE
fdx_mRNA	RNA
fldA	GENE
fldA_mRNA	RNA
glyceraldehyde-P	SIMPLE_MOLECULE	GAP
idi	GENE
idi_mRNA	RNA
isopentenyl-pp	SIMPLE_MOLECULE	DELTA3-ISOPENTENYL-PP
ispD	GENE
ispD_mRNA	RNA
ispE	GENE
ispE_mRNA	RNA
ispF	GENE
ispF_mRNA	RNA
ispG	GENE
ispG_mRNA	RNA
ispH	GENE
ispH_mRNA	RNA
oxidized ferredoxin	SIMPLE_MOLECULE	|Oxidized-ferredoxins|
pyruvate	SIMPLE_MOLECULE	PYRUVATE
reduced ferredoxin	SIMPLE_MOLECULE	|Reduced-ferredoxins|
