(2Z)-2-hydroxypenta-2,4-dienoate	SIMPLE_MOLECULE	CPD-14447
(2Z,4E)-2-hydroxy-6-ketononadienedioic acid	SIMPLE_MOLECULE	CPD-157
2,3-DHP	SIMPLE_MOLECULE	2-3-DIHYDROXYPHENYL-PROPIONATE
2,3-dihydroxycinnamic acid	SIMPLE_MOLECULE	CPD-10796
2-hydroxy-6-oxononatrienedioate	SIMPLE_MOLECULE	CPD0-2184
2-oxo-4-hydroxyvalerate	SIMPLE_MOLECULE	4-HYDROXY-2-KETOVALERATE
3-coumarate	SIMPLE_MOLECULE	CPD-10797
3HPP	SIMPLE_MOLECULE	3-HYDROXYPHENYL-PROPIONATE
MhpA	PROTEIN	MHPHYDROXY-MONOMER
MhpB	PROTEIN	DHPDIOXYGEN-MONOMER
MhpC	PROTEIN	MHPCHYDROL-MONOMER
MhpD	PROTEIN	MHPDHYDROL-MONOMER
MhpE	PROTEIN	MHPELY-MONOMER
MhpF	PROTEIN	MHPF-MONOMER
MhpR	PROTEIN
acetyl-CoA	SIMPLE_MOLECULE	ACETYL-COA
coenzyme A	SIMPLE_MOLECULE	CO-A
ethanal	SIMPLE_MOLECULE	ACETALD
fumarate	SIMPLE_MOLECULE	FUM
mhpA	GENE
mhpA_mRNA	RNA
mhpB	GENE
mhpB_mRNA	RNA
mhpC	GENE
mhpC_mRNA	RNA
mhpD	GENE
mhpD_mRNA	RNA
mhpE	GENE
mhpE_mRNA	RNA
mhpF	GENE
mhpF_mRNA	RNA
oxygen	SIMPLE_MOLECULE	OXYGEN-MOLECULE
pyruvate	SIMPLE_MOLECULE	PYRUVATE
succinate	SIMPLE_MOLECULE	SUC
