ErpA	PROTEIN	EG12332-MONOMER
IscA	PROTEIN	EG12132-MONOMER
IscR	PROTEIN	G7326-MONOMER
IscS	PROTEIN	G7325-MONOMER
IscU	PROTEIN	G7324-MONOMER
RnlA	PROTEIN	G7365-MONOMER
RnlB	PROTEIN	G7366-MONOMER
RnlB-RnlA	COMPLEX	CPLX0-7909
S-sulfanyl-[L-cysteine desulfurase]	SIMPLE_MOLECULE	|Persulfurated-L-cysteine-desulfurases|
S-sulfanyl-[cysteine desulfurase]-[disordered-form scaffold protein] complex	SIMPLE_MOLECULE	|S-CD-Apo-SP-Complex|
ThiI	SIMPLE_MOLECULE	|Sulfur-Carrier-Proteins-ThiI|
YdiU	PROTEIN	G6924-MONOMER
[L-cysteine desulfurase] L-cysteine persulfide	SIMPLE_MOLECULE	|L-Cysteine-Desulfurase-persulfide|
[disordered-form [Fe-S] cluster scaffold protein]	SIMPLE_MOLECULE	|D-form-FeS-Cluster-Scaffold-Proteins|
alanine	SIMPLE_MOLECULE	L-ALPHA-ALANINE
cystein desulfurase	SIMPLE_MOLECULE	|L-Cysteine-Desulfurases|
cysteine	SIMPLE_MOLECULE	CYS
erpA	GENE
erpA_mRNA	RNA
iscA	GENE
iscA_mRNA	RNA
iscR	GENE
iscR_mRNA	RNA
iscS	GENE
iscS_mRNA	RNA
iscU	GENE
iscU_mRNA	RNA
mRNA	SIMPLE_MOLECULE	|mRNAs|
mRNA fragments	SIMPLE_MOLECULE	|mRNA-Fragments|
protein cysteines	SIMPLE_MOLECULE	|Cysteine-Desulfurase-L-cysteine|
rnlA	GENE
rnlA_mRNA	RNA
rnlB	GENE
rnlB_mRNA	RNA
sulfurated sulfur donor	SIMPLE_MOLECULE	|Sulfurated-Sulfur-Acceptors|
sulfurylated sulfur-carrier protein ThiI	SIMPLE_MOLECULE	|Sulfurylated-ThiI|
unsulfurated [sulfur donor]	SIMPLE_MOLECULE	|Unsulfurated-Sulfur-Acceptors|
ydiU	GENE
ydiU_mRNA	RNA
