2-isopropyl-3-oxosuccinate	SIMPLE_MOLECULE	CPD-7100
2-isopropylmaleate	SIMPLE_MOLECULE	CPD-9451
2-keto-isoleucine	SIMPLE_MOLECULE	2-KETO-3-METHYL-VALERATE
2-ketovaline	SIMPLE_MOLECULE	2-KETO-ISOVALERATE
3-isopropylmalate	SIMPLE_MOLECULE	2-D-THREO-HYDROXY-3-CARBOXY-ISOCAPROATE
BCAT	PROTEIN	BRANCHED-CHAINAMINOTRANSFER-CPLX
CO2	SIMPLE_MOLECULE	CARBON-DIOXIDE
DmlA	PROTEIN	G6986-MONOMER
IlvE	PROTEIN	BRANCHED-CHAINAMINOTRANSFER-MONOMER
L-glutamate	SIMPLE_MOLECULE	GLT
LEUSYN-PWY	PROTEIN
LeuA	PROTEIN	2-ISOPROPYLMALATESYN-MONOMER
LeuB	PROTEIN	3-ISOPROPYLMALDEHYDROG-MONOMER
LeuC	PROTEIN	LEUC-MONOMER
LeuC-LeuD	COMPLEX	3-ISOPROPYLMALISOM-CPLX
LeuD	PROTEIN	LEUD-MONOMER
Oxaloglycolate	SIMPLE_MOLECULE	CPD-66
TyrB	PROTEIN	TYRB-MONOMER
acetyl-CoA	SIMPLE_MOLECULE	ACETYL-COA
alpha-isopropylmalate	SIMPLE_MOLECULE	3-CARBOXY-3-HYDROXY-ISOCAPROATE
aromatic amino acid	SIMPLE_MOLECULE	|Aromatic-Amino-Acids|
aromatic oxo-acid	SIMPLE_MOLECULE	|Aromatic-Oxoacids|
coenzyme A	SIMPLE_MOLECULE	CO-A
dmlA	GENE
dmlA_mRNA	RNA
hydroxyphenylpyruvate	SIMPLE_MOLECULE	P-HYDROXY-PHENYLPYRUVATE
ilvE	GENE
ilvE_mRNA	RNA
iso-leucine	SIMPLE_MOLECULE	ILE
ketoglutarate	SIMPLE_MOLECULE	2-KETOGLUTARATE
ketoleucine	SIMPLE_MOLECULE	2K-4CH3-PENTANOATE
leuA	GENE
leuA_mRNA	RNA
leuB	GENE
leuB_mRNA	RNA
leuC	GENE
leuC_mRNA	RNA
leuD	GENE
leuD_mRNA	RNA
leucine	SIMPLE_MOLECULE	LEU
malate	SIMPLE_MOLECULE	CPD-660
phenylalanine	SIMPLE_MOLECULE	PHE
phenylpyruvate	SIMPLE_MOLECULE	PHENYL-PYRUVATE
pyruvate	SIMPLE_MOLECULE	PYRUVATE
tartrate	SIMPLE_MOLECULE	TARTRATE
tyrB	GENE
tyrB_mRNA	RNA
tyrosine	SIMPLE_MOLECULE	TYR
valine	SIMPLE_MOLECULE	VAL
