5-ketogluconate	SIMPLE_MOLECULE	5-DEHYDROGLUCONATE
5-ketogluconate_Ext	SIMPLE_MOLECULE	5-DEHYDROGLUCONATE_Ext
6-p gluconate	SIMPLE_MOLECULE	CPD-2961
GntK	PROTEIN	GLUCONOKINII-MONOMER
GntU	PROTEIN	GNTU-MONOMER
IdnD	PROTEIN	IDONDEHYD-MONOMER
IdnO	PROTEIN	GLUCONREDUCT-MONOMER
IdnR	PROTEIN	G7891-MONOMER
IdnR-5-ketogluconate	PROTEIN
IdnT	PROTEIN	YJGT-MONOMER
gluconate	SIMPLE_MOLECULE	GLUCONATE
gluconate_Ext	SIMPLE_MOLECULE	GLUCONATE_Ext
gntK	GENE
gntK_mRNA	RNA
gntU	GENE
gntU_mRNA	RNA
idnD	GENE
idnD_mRNA	RNA
idnO	GENE
idnO_mRNA	RNA
idnR	GENE
idnR_mRNA	RNA
idnT	GENE
idnT_mRNA	RNA
idonate	SIMPLE_MOLECULE	L-IDONATE
idonate_Ext	SIMPLE_MOLECULE	L-IDONATE_Ext
