2-keto-3-deoxygluconate	SIMPLE_MOLECULE	2-DEHYDRO-3-DEOXY-D-GLUCONATE
4-hydroxy-2-oxoglutarate	SIMPLE_MOLECULE	CPD-15016
CO2	SIMPLE_MOLECULE	CARBON-DIOXIDE
Eda	PROTEIN	KDPGALDOL-4OH2OXOGLUTARALDOL-MONOMER
GALACTUROCAT-PWY	PROTEIN
KDGP	SIMPLE_MOLECULE	2-KETO-3-DEOXY-6-P-GLUCONATE
KdgK	PROTEIN	DEOXYGLUCONOKIN-MONOMER
UxaA	PROTEIN	ALTRODEHYDRAT-MONOMER
UxaB	PROTEIN	ALTRO-OXIDOREDUCT-MONOMER
UxaC	PROTEIN	UXAC-MONOMER
aldehydo-D-galacturonate	SIMPLE_MOLECULE	CPD-15633
aldehydo-D-glucuronate	SIMPLE_MOLECULE	CPD-15530
altronate	SIMPLE_MOLECULE	D-ALTRONATE
eda	GENE
eda_mRNA	RNA
fructuronate	SIMPLE_MOLECULE	FRUCTURONATE
glyceraldehyde-P	SIMPLE_MOLECULE	GAP
glyoxylate	SIMPLE_MOLECULE	GLYOX
kdgK	GENE
kdgK_mRNA	RNA
oxalacetate	SIMPLE_MOLECULE	OXALACETIC_ACID
pyruvate	SIMPLE_MOLECULE	PYRUVATE
tagaturonate	SIMPLE_MOLECULE	D-TAGATURONATE
uxaA	GENE
uxaA_mRNA	RNA
uxaB	GENE
uxaB_mRNA	RNA
uxaC	GENE
uxaC_mRNA	RNA
