2-deoxy-D-glucose 6-phosphate	SIMPLE_MOLECULE	2-DEOXY-D-GLUCOSE-6-PHOSPHATE
2-deoxyglucose_Ext	SIMPLE_MOLECULE	2-DEOXY-D-GLUCOSE_Ext
5'-IMP	SIMPLE_MOLECULE	IMP
5'-UMP	SIMPLE_MOLECULE	UMP
5'-ribonucleotide	SIMPLE_MOLECULE	|Ribonucleoside-Monophosphates|
ChbA	PROTEIN	CELC-MONOMER
ChbA-ChbC-ChbB	COMPLEX	CPLX-155
ChbB	PROTEIN	CELA-MONOMER
ChbC	PROTEIN	CELB-MONOMER
ChbF	PROTEIN	EG10144-MONOMER
ChbG	PROTEIN	EG12198-MONOMER
ChbR	PROTEIN	EG10143-MONOMER
ChiP	PROTEIN	G6370-MONOMER
ChiQ	PROTEIN	G6371-MONOMER
CreA	PROTEIN	EG11217-MONOMER
CreB	PROTEIN	CREB-MONOMER
CreC	PROTEIN	CREC-MONOMER
CreD	PROTEIN	EG10145-MONOMER
Crr	PROTEIN	CRR-MONOMER
DinI	PROTEIN	G6558-MONOMER
EIINag	PROTEIN	CPLX-167
Fe+2	SIMPLE_MOLECULE	FE+2
Fe+2_Ext	SIMPLE_MOLECULE	FE+2_Ext
FeoA	PROTEIN	EG12101-MONOMER
FeoB	PROTEIN	FEOB-MONOMER
FeoC	PROTEIN	EG12933-MONOMER
FimB	PROTEIN	EG10309-MONOMER
GalP	PROTEIN	GALP-MONOMER
GlmS	PROTEIN	L-GLN-FRUCT-6-P-AMINOTRANS-MONOMER
GlmU	PROTEIN	NAG1P-URIDYLTRANS-MONOMER
HPr - phosphorylated_Ext	SIMPLE_MOLECULE	PTSH-PHOSPHORYLATED_Ext
IIABMan	PROTEIN	CPLX0-7921
L-glutamate	SIMPLE_MOLECULE	GLT
ManNAc-6-P	SIMPLE_MOLECULE	N-ACETYL-D-MANNOSAMINE-6P
ManX	PROTEIN	MANX-MONOMER
ManY	PROTEIN	MANY-MONOMER
ManZ	PROTEIN	MANZ-MONOMER
ManZ-ManY-ManX	COMPLEX	CPLX-165
Methyl-D-glucoside_Ext	SIMPLE_MOLECULE	CPD-3582_Ext
MtlR	PROTEIN	PD00369
MtlR-PtsH	COMPLEX	MONOMER0-2461
MurNAc-6-P	SIMPLE_MOLECULE	CPD0-881
MurNAc_Ext	SIMPLE_MOLECULE	NACMUR_Ext
MurP	PROTEIN	MONOMER0-5
MurP-Crr	COMPLEX	CPLX0-7
N-acetyl-D-glucosamine 6-phosphate	SIMPLE_MOLECULE
N-acetyl-alpha-D-glucosamine 1-phosphate	SIMPLE_MOLECULE	N-ACETYL-D-GLUCOSAMINE-1-P
N-acetyl-alpha-D-glucosamine 6-phosphate	SIMPLE_MOLECULE	N-ACETYL-D-GLUCOSAMINE-6-P
N-acetyl-beta-D-mannosamine_Ext	SIMPLE_MOLECULE	|N-acetyl-D-mannosamine|_Ext
N-acetylneuraminate	SIMPLE_MOLECULE	N-ACETYLNEURAMINATE
N-acetylneuraminate_Ext	SIMPLE_MOLECULE	N-ACETYLNEURAMINATE_Ext
N-monoacetylchitobiose	SIMPLE_MOLECULE	CPD-12274
N-monoacetylchitobiose 6'-phosphate	SIMPLE_MOLECULE	CPD0-2501
NAcGlc_Ext	SIMPLE_MOLECULE	|N-acetyl-D-glucosamine|_Ext
NagA	PROTEIN	NAG6PDEACET-MONOMER
NagB	PROTEIN	GLUCOSAMINE-6-P-DEAMIN-MONOMER
NagC	PROTEIN
NagC-N-acetyl-D-glucosamine 6-phosphate	COMPLEX
NagE	PROTEIN	NAGE-MONOMER
NanC	PROTEIN	G7921-MONOMER
NanM	PROTEIN	G7920-MONOMER
NanS	PROTEIN	G7919-MONOMER
PtsG	PROTEIN	PTSG-MONOMER
PtsG-Crr	COMPLEX	CPLX-157
PtsH	PROTEIN	PTSH-MONOMER
PtsH	SIMPLE_MOLECULE	PTSH-MONOMER
PtsI	PROTEIN	PTSI-MONOMER
TreB	PROTEIN	TREB-MONOMER
TreB-Crr	COMPLEX	CPLX-168
UDP-GlcNAc	SIMPLE_MOLECULE	UDP-N-ACETYL-D-GLUCOSAMINE
UmpH	PROTEIN	EG10634-MONOMER
YdeM	PROTEIN	G6787-MONOMER
YdeN	PROTEIN	G6788-MONOMER
YdeP	PROTEIN	G6791-MONOMER
YjjE	PROTEIN	PHOSPHO-CREB
acetate	SIMPLE_MOLECULE	ACET
acetyl-CoA	SIMPLE_MOLECULE	ACETYL-COA
alpha,alpha-trehalose 6-phosphate	SIMPLE_MOLECULE	TREHALOSE-6P
alpha-D-glucosamine phosphate	SIMPLE_MOLECULE	CPD-13469
alpha-D-glucosamine phosphate	SIMPLE_MOLECULE	D-GLUCOSAMINE-6-P
alpha-Neu5Ac	SIMPLE_MOLECULE	CPD0-1122
ammonium	SIMPLE_MOLECULE	AMMONIUM
beta-D-cellobiose-6'-p	SIMPLE_MOLECULE	CPD-15978
beta-D-cellobiose-6'-p	SIMPLE_MOLECULE	CPD-507
beta-D-cellobiose_Ext	SIMPLE_MOLECULE	CELLOBIOSE_Ext
beta-Neu5Ac	SIMPLE_MOLECULE	CPD0-1123
beta-Neu5Ac_Ext	SIMPLE_MOLECULE	CPD0-1123_Ext
chbBCARFG	GENE
chbBCARFG_mRNA	RNA
chiPQ	GENE
chiPQ_mRNA	RNA
chitobiose	SIMPLE_MOLECULE	CHITOBIOSE
chitobiose_Ext	SIMPLE_MOLECULE	CHITOBIOSE_Ext
chitosamine	SIMPLE_MOLECULE	GLUCOSAMINE
chitosamine_Ext	SIMPLE_MOLECULE	GLUCOSAMINE_Ext
coenzyme A	SIMPLE_MOLECULE	CO-A
creABCD	GENE
creABCD_mRNA	RNA
cytidine	SIMPLE_MOLECULE	CYTIDINE
cytidylate	SIMPLE_MOLECULE	CMP
diacetylchitobiose 6-phosphate	SIMPLE_MOLECULE	DIACETYLCHITOBIOSE-6-PHOSPHATE
dinI	GENE
dinI_mRNA	RNA
diphosphate	SIMPLE_MOLECULE	PPI
feoABC	GENE
feoABC_mRNA	RNA
fimB	GENE
fimB_mRNA	RNA
fructofuranose_Ext	SIMPLE_MOLECULE	|Fructofuranose|_Ext
fructose-6-P	SIMPLE_MOLECULE	FRUCTOSE-6P
galP	GENE
galP_mRNA	RNA
galactopyranose	SIMPLE_MOLECULE	|D-galactopyranose|
galactopyranose_Ext	SIMPLE_MOLECULE	|D-galactopyranose|_Ext
glmUS	GENE
glmUS_mRNA	RNA
glucopyranose	SIMPLE_MOLECULE	|Glucopyranose|
glucopyranose_Ext	SIMPLE_MOLECULE	|Glucopyranose|_Ext
glucosamine-1P	SIMPLE_MOLECULE	GLUCOSAMINE-1P
glucose-6-P	SIMPLE_MOLECULE	|D-glucopyranose-6-phosphate|
glutamine	SIMPLE_MOLECULE	GLN
guanosine	SIMPLE_MOLECULE	GUANOSINE
guanylate	SIMPLE_MOLECULE	GMP
inosine	SIMPLE_MOLECULE	INOSINE
keto-D-fructose 6-phosphate	SIMPLE_MOLECULE	CPD-18719
manXYZ	GENE
manXYZ_mRNA	RNA
mannopyranose-6-P	SIMPLE_MOLECULE	CPD-15979
methyl alpha-D-glucoside 6-phosphate	SIMPLE_MOLECULE	CPD-16619
nagBAC-umpH	GENE
nagBAC-umpH_mRNA	RNA
nagE	GENE
nagE_mRNA	RNA
nanCM	GENE
nanCMS	GENE
nanCMS_mRNA	RNA
nanCM_mRNA	RNA
nucleoside	SIMPLE_MOLECULE	|Ribonucleosides|
phosphate	SIMPLE_MOLECULE	|Pi|
ptsHI-crr	GENE
ptsHI-crr_mRNA	RNA
seminose_Ext	SIMPLE_MOLECULE	|D-mannopyranose|_Ext
trehalose_Ext	SIMPLE_MOLECULE	TREHALOSE_Ext
uridine	SIMPLE_MOLECULE	URIDINE
uridine-triphosphate	SIMPLE_MOLECULE	UTP
ydeNM	GENE
ydeNM_mRNA	RNA
ydeP	GENE
ydeP_mRNA	RNA
