5'-UMP	SIMPLE_MOLECULE	UMP
D-glucose 1-phosphate	SIMPLE_MOLECULE	GLC-1-P
ECASYN-PWY	PROTEIN
RfbA	PROTEIN	DTDPGLUCOSEPP-MONOMER
Rfe	PROTEIN	GLCNACPTRANS-MONOMER
RffC	PROTEIN	TDPFUCACTRANS-MONOMER
RffG	PROTEIN	DTDPGLUCDEHYDRAT2-MONOMER
RffH	PROTEIN	DTDPGLUCOSEPP2-MONOMER
RffM	PROTEIN	UDPMANACATRANS-MONOMER
RffT	PROTEIN	G7800-MONOMER
TDP-4-oxo-6-deoxy--alpha-D-glucose	SIMPLE_MOLECULE	DTDP-DEOH-DEOXY-GLUCOSE
TDP-Fuc4NAc	SIMPLE_MOLECULE	TDP-FUC4NAC
TDP-glucose	SIMPLE_MOLECULE	DTDP-D-GLUCOSE
UDP-GlcNAc	SIMPLE_MOLECULE	UDP-N-ACETYL-D-GLUCOSAMINE
UDP-ManNAc	SIMPLE_MOLECULE	UDP-MANNAC
UDP-ManNAcA	SIMPLE_MOLECULE	UDP-MANNACA
WecB	PROTEIN	UDPGLCNACEPIM-MONOMER
WecC	PROTEIN	UDPMANNACADEHYDROG-MONOMER
acetyl-CoA	SIMPLE_MOLECULE	ACETYL-COA
coenzyme A	SIMPLE_MOLECULE	CO-A
dTDP	SIMPLE_MOLECULE	TDP
dTDP-thomosamine	SIMPLE_MOLECULE	TDP-D-FUCOSAMINE
dTTP	SIMPLE_MOLECULE	TTP
diphosphate	SIMPLE_MOLECULE	PPI
ditrans,polycis-undecaprenyl phosphate	SIMPLE_MOLECULE	CPD-9646
lipid I	SIMPLE_MOLECULE	ACETYL-D-GLUCOSAMINYLDIPHOSPHO-UNDECAPRE
lipid II	SIMPLE_MOLECULE	C55-PP-GLCNAC-MANNACA
lipid III	SIMPLE_MOLECULE	C55-PP-GLCNAC-MANNACA-FUC4NAC
rfbA	GENE
rfbA_mRNA	RNA
rfe	GENE
rfe_mRNA	RNA
rffC	GENE
rffC_mRNA	RNA
rffG	GENE
rffG_mRNA	RNA
rffH	GENE
rffH_mRNA	RNA
rffM	GENE
rffM_mRNA	RNA
rffT	GENE
rffT_mRNA	RNA
uridine-diphosphate	SIMPLE_MOLECULE	UDP
wecB	GENE
wecB_mRNA	RNA
wecC	GENE
wecC_mRNA	RNA
