1,2-propanediol	SIMPLE_MOLECULE	PROPANE-1-2-DIOL
2-hydroxybutyrate	SIMPLE_MOLECULE	CPD-3564
2-oxobutyrate	SIMPLE_MOLECULE	2-OXOBUTANOATE
AldA	PROTEIN	LACTALDDEHYDROG-MONOMER
DHAP	SIMPLE_MOLECULE	DIHYDROXY-ACETONE-PHOSPHATE
FUC-RHAMCAT-PWY	PROTEIN
FucA	PROTEIN	FUCPALDOL-MONOMER
FucI	PROTEIN	FUCISOM-MONOMER
FucK	PROTEIN	FUCULOKIN-MONOMER
FucO	PROTEIN	LACTALDREDUCT-MONOMER
FucU	PROTEIN	EG10355-MONOMER
LldD	PROTEIN	L-LACTDEHYDROGFMN-MONOMER
RhaA	PROTEIN	RHAMNISOM-MONOMER
RhaB	PROTEIN	RHAMNULOKIN-MONOMER
RhaD	PROTEIN	RHAMNULPALDOL-MONOMER
RhaM	PROTEIN	EG11865-MONOMER
aldA	GENE
aldA_mRNA	RNA
alpha-L-fucose	SIMPLE_MOLECULE	CPD-10329
arabinopyranose	SIMPLE_MOLECULE	|D-arabinopyranose|
beta-L-fucose	SIMPLE_MOLECULE	CPD0-1107
beta-L-lyxose	SIMPLE_MOLECULE	L-LYXOSE
beta-L-rhamnopyranose	SIMPLE_MOLECULE	CPD0-1112
electron-transfer quinol	SIMPLE_MOLECULE	|ETR-Quinols|
electron-transfer quinone	SIMPLE_MOLECULE	|ETR-Quinones|
fucA	GENE
fucA_mRNA	RNA
fucI	GENE
fucI_mRNA	RNA
fucK	GENE
fucK_mRNA	RNA
fucO	GENE
fucO_mRNA	RNA
fucU	GENE
fucU_mRNA	RNA
fuculose	SIMPLE_MOLECULE	L-FUCULOSE
fuculose-1-P	SIMPLE_MOLECULE	FUCULOSE-1P
glycoaldehyde	SIMPLE_MOLECULE	GLYCOLALDEHYDE
glycol	SIMPLE_MOLECULE	GLYCOL
glycolate	SIMPLE_MOLECULE	GLYCOLLATE
isodulcit	SIMPLE_MOLECULE	RHAMNOSE
keto-L-rhamnulose	SIMPLE_MOLECULE	CPD-16566
lactaldehyde	SIMPLE_MOLECULE	LACTALD
lactate	SIMPLE_MOLECULE	L-LACTATE
lldD	GENE
lldD_mRNA	RNA
pyruvate	SIMPLE_MOLECULE	PYRUVATE
rhaA	GENE
rhaA_mRNA	RNA
rhaB	GENE
rhaB_mRNA	RNA
rhaD	GENE
rhaD_mRNA	RNA
rhaM	GENE
rhaM_mRNA	RNA
rhamnulofuranose	SIMPLE_MOLECULE	CPD-16567
rhamnulose-1P	SIMPLE_MOLECULE	RHAMNULOSE-1P
ribulose	SIMPLE_MOLECULE	D-RIBULOSE
ribulose-1-P	SIMPLE_MOLECULE	D-RIBULOSE-1-P
xylulose	SIMPLE_MOLECULE	L-XYLULOSE
