5-(2-hydroxyethyl)-4-methylthiazole	SIMPLE_MOLECULE	THZ
CO2	SIMPLE_MOLECULE	CARBON-DIOXIDE
HMP-P	SIMPLE_MOLECULE	AMINO-HYDROXYMETHYL-METHYL-PYR-P
HMP-PP	SIMPLE_MOLECULE	AMINO-HYDROXYMETHYL-METHYLPYRIMIDINE-PP
PWY-6897	PROTEIN
PdxK	PROTEIN	PDXK-MONOMER
THZ-P	SIMPLE_MOLECULE	THZ-P
ThPP	SIMPLE_MOLECULE	THIAMINE-PYROPHOSPHATE
ThiD	PROTEIN	HMP-P-KIN-MONOMER
ThiE	PROTEIN	THIE-MONOMER
ThiL	PROTEIN	THI-P-KIN-MONOMER
ThiM	PROTEIN	THZ-KIN-MONOMER
cThz*-P	SIMPLE_MOLECULE	CPD-13575
diphosphate	SIMPLE_MOLECULE	PPI
pdxK	GENE
pdxK_mRNA	RNA
pyramin	SIMPLE_MOLECULE	HMP
pyridoxal	SIMPLE_MOLECULE	PYRIDOXAL
pyridoxamine	SIMPLE_MOLECULE	PYRIDOXAMINE
pyridoxamine phosphate	SIMPLE_MOLECULE	PYRIDOXAMINE-5P
pyridoxine-P	SIMPLE_MOLECULE	PYRIDOXINE-5P
pyridoxol	SIMPLE_MOLECULE	PYRIDOXINE
thiD	GENE
thiD_mRNA	RNA
thiE	GENE
thiE_mRNA	RNA
thiL	GENE
thiL_mRNA	RNA
thiM	GENE
thiM_mRNA	RNA
thiamin-P	SIMPLE_MOLECULE	THIAMINE-P
vitamin B6	SIMPLE_MOLECULE	PYRIDOXAL_PHOSPHATE
