5'-IMP	SIMPLE_MOLECULE	IMP
Gpt	PROTEIN	GPT-MONOMER
PRPP	SIMPLE_MOLECULE	PRPP
SALVPURINE2-PWY	PROTEIN
XapA	PROTEIN	XANTHOSINEPHOSPHORY-MONOMER
diphosphate	SIMPLE_MOLECULE	PPI
gpt	GENE
gpt_mRNA	RNA
guanine	SIMPLE_MOLECULE	GUANINE
guanosine	SIMPLE_MOLECULE	GUANOSINE
guanylate	SIMPLE_MOLECULE	GMP
hypoxanthine	SIMPLE_MOLECULE	HYPOXANTHINE
inosine	SIMPLE_MOLECULE	INOSINE
nicotinamide ribose	SIMPLE_MOLECULE	NICOTINAMIDE_RIBOSE
phosphate	SIMPLE_MOLECULE	|Pi|
ribose-1-phosphate	SIMPLE_MOLECULE	RIBOSE-1P
vitamin PP	SIMPLE_MOLECULE	NIACINAMIDE
xanthine	SIMPLE_MOLECULE	XANTHINE
xanthosine	SIMPLE_MOLECULE	XANTHOSINE
xanthosine-5-P	SIMPLE_MOLECULE	XANTHOSINE-5-PHOSPHATE
xapA	GENE
xapA_mRNA	RNA
