1,6-anhMurNAc	SIMPLE_MOLECULE	CPD0-882
Ala-D-Glu-meso-A2pm-D-Ala	SIMPLE_MOLECULE	CPD0-1082
Ala-gamma-D-Glu-Dap	SIMPLE_MOLECULE	L-ALA-GAMMA-D-GLU-DAP
AmiD	PROTEIN	G6452-MONOMER
AmpD	PROTEIN	EG10041-MONOMER
AnmK	PROTEIN	G6880-MONOMER
GlcNAc-1,6-anhMurNAc-L-Ala-gamma-D-Glu-DAP-D-Ala	SIMPLE_MOLECULE	CPD0-1080
GlmM	PROTEIN	PHOSGLUCOSAMINEMUT-MONOMER
GlmU	PROTEIN	NAG1P-URIDYLTRANS-MONOMER
LdcA	PROTEIN	G6621-MONOMER
MepS	PROTEIN	G7147-MONOMER
Mpl	PROTEIN	EG12440-MONOMER
MurNAc-6-P	SIMPLE_MOLECULE	CPD0-881
MurQ	PROTEIN	G7263-MONOMER
N-acetyl-alpha-D-glucosamine 1-phosphate	SIMPLE_MOLECULE	N-ACETYL-D-GLUCOSAMINE-1-P
N-acetyl-alpha-D-glucosamine 6-phosphate	SIMPLE_MOLECULE	N-ACETYL-D-GLUCOSAMINE-6-P
N-acetyl-beta-D-hexosamine	SIMPLE_MOLECULE	|N-acetyl-beta-D-hexosamines|
N-acetyl-beta-D-hexosaminide	SIMPLE_MOLECULE	|N-Acetyl-beta-D-Hexosaminides|
NAcGlc	SIMPLE_MOLECULE	N-ACETYL-D-GLUCOSAMINE
NagA	PROTEIN	NAG6PDEACET-MONOMER
NagZ	PROTEIN	G6567-MONOMER
PWY0-1261	PROTEIN
UDP-GlcNAc	SIMPLE_MOLECULE	UDP-N-ACETYL-D-GLUCOSAMINE
UDP-MurNAc	SIMPLE_MOLECULE	UDP-N-ACETYLMURAMATE
UDP-MurNAc-L-Ala-gamma-D-Glu-meso-A2pm	SIMPLE_MOLECULE	UDP-AAGM-DIAMINOHEPTANEDIOATE
UDP-MurNAc-tetrapeptide	SIMPLE_MOLECULE	UDP-MURNAC-TETRAPEPTIDE
acetate	SIMPLE_MOLECULE	ACET
acetyl-CoA	SIMPLE_MOLECULE	ACETYL-COA
ala	SIMPLE_MOLECULE	D-ALANINE
alcohol	SIMPLE_MOLECULE	|Alcohols|
alpha-D-glucosamine phosphate	SIMPLE_MOLECULE	D-GLUCOSAMINE-6-P
amiD	GENE
amiD_mRNA	RNA
ampD	GENE
ampD_mRNA	RNA
anmK	GENE
anmK_mRNA	RNA
coenzyme A	SIMPLE_MOLECULE	CO-A
diphosphate	SIMPLE_MOLECULE	PPI
glcNAc-1,6-anhMurNAc	SIMPLE_MOLECULE	CPD0-1081
glmM	GENE
glmM_mRNA	RNA
glmU	GENE
glmU_mRNA	RNA
glucosamine 1,6-diphosphate	SIMPLE_MOLECULE	CPD0-1096
glucosamine-1P	SIMPLE_MOLECULE	GLUCOSAMINE-1P
lactate	SIMPLE_MOLECULE	D-LACTATE
ldcA	GENE
ldcA_mRNA	RNA
mepS	GENE
mepS_mRNA	RNA
mpl	GENE
mpl_mRNA	RNA
murQ	GENE
murQ_mRNA	RNA
nagA	GENE
nagA_mRNA	RNA
nagZ	GENE
nagZ_mRNA	RNA
peptidoglycan D-alanyl-DAP crosslink	SIMPLE_MOLECULE	CPD0-1181
peptidoglycan tetrapeptide, glycan chain 1	SIMPLE_MOLECULE	CPD0-1182
peptidoglycan tetrapeptide, glycan chain 2	SIMPLE_MOLECULE	CPD0-1183
phosphate	SIMPLE_MOLECULE	|Pi|
phosphoglucosamine mutase	SIMPLE_MOLECULE	|Phosphoglucosamine-Mutase|
phosphorylated phosphoglucosamine mutase	SIMPLE_MOLECULE	|Phosphorylated-Phosphoglucosamine-Mutase|
uridine-triphosphate	SIMPLE_MOLECULE	UTP
