CcmA	PROTEIN	CCMA-MONOMER
CcmB	PROTEIN	CCMB-MONOMER
CcmC	PROTEIN	CCMC-MONOMER
CcmD	PROTEIN	EG12169-MONOMER
CcmD-CcmB-CcmA-CcmE-CcmC	COMPLEX	ABC-35-CPLX
CcmE	PROTEIN	CCME-MONOMER
CcmE-CcmF-CcmG-CcmH	COMPLEX	CPLX0-3323
CcmF	PROTEIN	EG12054-MONOMER
CcmG	PROTEIN	EG12053-MONOMER
CcmH	PROTEIN	EG12052-MONOMER
FdnG	PROTEIN	FDNG-MONOMER
FdnH	PROTEIN	FDNH-MONOMER
FdnI	PROTEIN	FDNI-MONOMER
FdnI-FdnH-FdnG	COMPLEX	ALPHA-SUBUNIT-CPLX
FlRd	PROTEIN	CPLX0-1
FlRd	SIMPLE_MOLECULE	CPLX0-1
HyaA	PROTEIN	HYAA-MONOMER
HyaA-HyaB-HyaC	COMPLEX	FORMHYDROGI-CPLX
HyaB	PROTEIN	HYAB-MONOMER
HyaC	PROTEIN	HYAC-MONOMER
HyaD	PROTEIN	EG10471-MONOMER
HyaE	PROTEIN	EG10472-MONOMER
HyaF	PROTEIN	EG10473-MONOMER
NapA	PROTEIN	NAPA-MONOMER
NapB	PROTEIN	NAPB-MONOMER
NapB-NapA	COMPLEX	NAP-CPLX
NapC	PROTEIN	NAPC-MONOMER
NapD	PROTEIN	NAPD-MONOMER
NapF	PROTEIN	NAPF-MONOMER
NapG	PROTEIN	NAPG-MONOMER
NapG-NapH	COMPLEX	CPLX0-3241
NapH	PROTEIN	NAPH-MONOMER
NarP-Phosphorylated	PROTEIN
NorV	PROTEIN	CPLX0-2
NorW	PROTEIN	EG12450-MONOMER
Oxidized-NapC-proteins	SIMPLE_MOLECULE	|Oxidized-NapC-proteins|
Reduced-NapC-proteins	SIMPLE_MOLECULE	|Reduced-NapC-proteins|
YdeP	PROTEIN	G6791-MONOMER
YdhT	PROTEIN	G6897-MONOMER
YdhU	PROTEIN	G6898-MONOMER
YdhV	PROTEIN	G6901-MONOMER
YdhW	PROTEIN	G6900-MONOMER
YdhX	PROTEIN	G6899-MONOMER
YdhY	PROTEIN	G6902-MONOMER
ccmA	GENE
ccmA_mRNA	RNA
ccmB	GENE
ccmB_mRNA	RNA
ccmC	GENE
ccmC_mRNA	RNA
ccmD	GENE
ccmD_mRNA	RNA
ccmE	GENE
ccmE_mRNA	RNA
ccmF	GENE
ccmF_mRNA	RNA
ccmG	GENE
ccmG_mRNA	RNA
ccmH	GENE
ccmH_mRNA	RNA
fdnG	GENE
fdnG_mRNA	RNA
fdnH	GENE
fdnH_mRNA	RNA
fdnI	GENE
fdnI_mRNA	RNA
ferri c-type cytochrome	SIMPLE_MOLECULE	|Cytochromes-C-Oxidized|
hyaA	GENE
hyaA_mRNA	RNA
hyaB	GENE
hyaB_mRNA	RNA
hyaC	GENE
hyaC_mRNA	RNA
hyaD	GENE
hyaD_mRNA	RNA
hyaE	GENE
hyaE_mRNA	RNA
hyaF	GENE
hyaF_mRNA	RNA
menaquinol	SIMPLE_MOLECULE	|Menaquinols|
napA	GENE
napA_mRNA	RNA
napB	GENE
napB_mRNA	RNA
napC	GENE
napC_mRNA	RNA
napD	GENE
napD_mRNA	RNA
napF	GENE
napF_mRNA	RNA
napG	GENE
napG_mRNA	RNA
napH	GENE
napH_mRNA	RNA
neg	PROTEIN
nitrate	SIMPLE_MOLECULE	NITRATE
nitrite	SIMPLE_MOLECULE	NITRITE
norV	GENE
norV_mRNA	RNA
norW	GENE
norW_mRNA	RNA
oxidized flavorubredoxin	SIMPLE_MOLECULE	CPLX0-2
protoheme IX	SIMPLE_MOLECULE	PROTOHEME
protoheme IX_Ext	SIMPLE_MOLECULE	PROTOHEME_Ext
reduced Cytochrome C protein	SIMPLE_MOLECULE	|Cytochromes-C-Reduced|
ubiquinol	SIMPLE_MOLECULE	|Ubiquinols|
ubiquinone	SIMPLE_MOLECULE	|Ubiquinones|
vitamin K2	SIMPLE_MOLECULE	|Menaquinones|
ydeP	GENE
ydeP_mRNA	RNA
ydhT	GENE
ydhT_mRNA	RNA
ydhU	GENE
ydhU_mRNA	RNA
ydhV	GENE
ydhV_mRNA	RNA
ydhW	GENE
ydhW_mRNA	RNA
ydhX	GENE
ydhX_mRNA	RNA
ydhY	GENE
ydhY_mRNA	RNA
