ADP-Maltotriose	SIMPLE_MOLECULE
Aes	PROTEIN
D-glucose 1-phosphate	SIMPLE_MOLECULE	GLC-1-P
LamB	PROTEIN	EG10528-MONOMER
MalE	PROTEIN	MALE-MONOMER
MalF	PROTEIN	MALF-MONOMER
MalG	PROTEIN	MALG-MONOMER
MalK	PROTEIN
MalK	PROTEIN	MALK-MONOMER
MalK-MalF-MalG-MalE	COMPLEX	ABC-16-CPLX
MalM	PROTEIN	EG10559-MONOMER
MalP	PROTEIN	MALDEXPHOSPHORYL-MONOMER
MalQ	PROTEIN	AMYLOMALT-MONOMER
MalS	PROTEIN	ALPHA-AMYL-PERI-MONOMER
MalT	PROTEIN
MalT-ADP-Maltotriose	COMPLEX
MalT-Aes	COMPLEX
MalT-MalK	COMPLEX
MalT-MalY	COMPLEX
MalT-maltotriose-ATP	COMPLEX
MalY	PROTEIN
MalZ	PROTEIN	MALTODEXGLUCOSID-MONOMER
amylose	SIMPLE_MOLECULE	|1-4-alpha-D-Glucan|
debranched alpha-limit dextrin	SIMPLE_MOLECULE	CPD0-1027
glucopyranose	SIMPLE_MOLECULE	|Glucopyranose|
malEFG	GENE
malEFG_mRNA	RNA
malK-lamB-malM	GENE
malK-lamB-malM_mRNA	RNA
malPQ	GENE
malPQ_mRNA	RNA
malS	GENE
malS_mRNA	RNA
malZ	GENE
malZ_mRNA	RNA
maltoheptaose	SIMPLE_MOLECULE	CPD0-1133
maltohexaose	SIMPLE_MOLECULE	MALTOHEXAOSE
maltopentaose	SIMPLE_MOLECULE	MALTOPENTAOSE
maltose	SIMPLE_MOLECULE	MALTOSE
maltose_Ext	SIMPLE_MOLECULE	MALTOSE_Ext
maltotetraose	SIMPLE_MOLECULE	MALTOTETRAOSE
maltotetraose_Ext	SIMPLE_MOLECULE	MALTOTETRAOSE_Ext
maltotriose	SIMPLE_MOLECULE	MALTOTRIOSE
maltotriose-ATP	SIMPLE_MOLECULE
maltotriose_Ext	SIMPLE_MOLECULE	MALTOTRIOSE_Ext
non-specific ion/solute	SIMPLE_MOLECULE	|Unspecified-Ion-Or-Solute|
non-specific ion/solute_Ext	SIMPLE_MOLECULE	|Unspecified-Ion-Or-Solute|_Ext
phosphate	SIMPLE_MOLECULE	|Pi|
