5'-deoxyadenosine	SIMPLE_MOLECULE	CH33ADO
AceF	SIMPLE_MOLECULE	ACEF-LIPOATE
AceF	SIMPLE_MOLECULE	E2P-MONOMER
C-8 acid	SIMPLE_MOLECULE	CPD-195
Fdx	PROTEIN	FERREDOXIN-MONOMER
LipA	PROTEIN	EG11306-MONOMER
LplA	PROTEIN	EG11796-MONOMER
PWY0-1275	PROTEIN
SAM	SIMPLE_MOLECULE	S-ADENOSYLMETHIONINE
SucB	SIMPLE_MOLECULE	E2O-MONOMER
SucB	SIMPLE_MOLECULE	SUCB-LIPOATE
[glycine-cleavage complex H protein] N6-lipoyl-L-lysine	SIMPLE_MOLECULE	PROTEIN-LIPOYLLYSINE
[lipoyl-carrier protein]-L-lysine	SIMPLE_MOLECULE	|Lipoyl-Protein-L-Lysine|
diphosphate	SIMPLE_MOLECULE	PPI
fdx	GENE
fdx_mRNA	RNA
gcv protein H	SIMPLE_MOLECULE	|Gcv-H|
lipA	GENE
lipA_mRNA	RNA
lipoic acid	SIMPLE_MOLECULE	LIPOIC-ACID
lipoyl-AMP	SIMPLE_MOLECULE	LIPOYL-AMP
lipoyl-domain	SIMPLE_MOLECULE	|Lipoyl-Protein-N6-lipoyllysine|
lplA	GENE
lplA_mRNA	RNA
methionine	SIMPLE_MOLECULE	MET
octanoylated protein lipoyl-domain	SIMPLE_MOLECULE	|Octanoylated-domains|
oxidized [2Fe-2S] ferredoxin	SIMPLE_MOLECULE	|Oxidized-2Fe-2S-Ferredoxins|
reduced [2Fe-2S] ferredoxin	SIMPLE_MOLECULE	|Reduced-2Fe-2S-Ferredoxins|
sulfurated sulfur donor	SIMPLE_MOLECULE	|Sulfurated-Sulfur-Acceptors|
unsulfurated [sulfur donor]	SIMPLE_MOLECULE	|Unsulfurated-Sulfur-Acceptors|
