3-oxothreonine	SIMPLE_MOLECULE	AMINO-OXOBUT
RCH2NH2	SIMPLE_MOLECULE	|Aliphatic-Amines|
RCHO	SIMPLE_MOLECULE	|Aldehydes|
THRDLCTCAT-PWY	PROTEIN
Tdh	PROTEIN	THREODEHYD-MONOMER
TynA	PROTEIN	AMINEOXID-MONOMER
YiaY	PROTEIN	EG12293-MONOMER
aminoacetone	SIMPLE_MOLECULE	AMINO-ACETONE
ammonium	SIMPLE_MOLECULE	AMMONIUM
hyacinthin	SIMPLE_MOLECULE	PHENYLACETALDEHYDE
oxopropanal	SIMPLE_MOLECULE	METHYL-GLYOXAL
oxygen	SIMPLE_MOLECULE	OXYGEN-MOLECULE
perhydrol	SIMPLE_MOLECULE	HYDROGEN-PEROXIDE
phenethylamine	SIMPLE_MOLECULE	PHENYLETHYLAMINE
primary amine	SIMPLE_MOLECULE	|Primary-Amines|
tdh	GENE
tdh_mRNA	RNA
threonine	SIMPLE_MOLECULE	THR
tynA	GENE
tynA_mRNA	RNA
yiaY	GENE
yiaY_mRNA	RNA
