L-glutamate	SIMPLE_MOLECULE	GLT
NAAD	SIMPLE_MOLECULE	DEAMIDO-NAD
NaMN	SIMPLE_MOLECULE	NICOTINATE_NUCLEOTIDE
NadD	PROTEIN	NICONUCADENYLYLTRAN-MONOMER
NadE	PROTEIN	NAD-SYNTH-MONOMER
PRPP	SIMPLE_MOLECULE	PRPP
PYRIDNUCSAL-PWY	PROTEIN
PncA	PROTEIN	NICOTINAMID-MONOMER
PncB	PROTEIN	NICOTINATEPRIBOSYLTRANS-MONOMER
PncC	PROTEIN	G7409-MONOMER
ammonium	SIMPLE_MOLECULE	AMMONIUM
beta-nicotinamide nucleotide	SIMPLE_MOLECULE	NICOTINAMIDE_NUCLEOTIDE
diphosphate	SIMPLE_MOLECULE	PPI
glutamine	SIMPLE_MOLECULE	GLN
nadD	GENE
nadD_mRNA	RNA
nadE	GENE
nadE_mRNA	RNA
niacin	SIMPLE_MOLECULE	NIACINE
phosphate	SIMPLE_MOLECULE	|Pi|
pncA	GENE
pncA_mRNA	RNA
pncB	GENE
pncB_mRNA	RNA
pncC	GENE
pncC_mRNA	RNA
pyrazinamide	SIMPLE_MOLECULE	PYRAZINAMIDE
pyrazinoate	SIMPLE_MOLECULE	PYRAZINOIC-ACID
vitamin PP	SIMPLE_MOLECULE	NIACINAMIDE
