(CH3)3NH	SIMPLE_MOLECULE	TRIMETHYLAMINE
CO2	SIMPLE_MOLECULE	CARBON-DIOXIDE
GABA	SIMPLE_MOLECULE	4-AMINO-BUTYRATE
GadA	PROTEIN	GLUTDECARBOXA-MONOMER
GadX	PROTEIN	EG12243-MONOMER
HdeA	PROTEIN	EG11398-MONOMER
HdeB	PROTEIN	EG11399-MONOMER
L-glutamate	SIMPLE_MOLECULE	GLT
TMAO	SIMPLE_MOLECULE	TRIMETHYLAMINE-N-O
TnaA	PROTEIN	TRYPTOPHAN-MONOMER
TnaB	PROTEIN	TNAB-MONOMER
TnaC	PROTEIN	EG11276-MONOMER
TorA	PROTEIN	TORA-MONOMER
TorC	PROTEIN	EG11815-MONOMER
TorC-TorA	COMPLEX	TMAOREDUCTI-CPLX
TorD	PROTEIN	EG12195-MONOMER
TorI	PROTEIN
TorR	PROTEIN
TorR-TorI	COMPLEX
TorR-phosphate	COMPLEX
YhiD	PROTEIN	EG11400-MONOMER
a-reduced-TorC-protein	SIMPLE_MOLECULE	|a-reduced-TorC-protein|
ammonium	SIMPLE_MOLECULE	AMMONIUM
an-oxidized-TorC-protein	SIMPLE_MOLECULE	|an-oxidized-TorC-protein|
cysteine	SIMPLE_MOLECULE	CYS
dehydroalanine	SIMPLE_MOLECULE	2-AMINOACRYLATE
gadAX	GENE
gadAX_mRNA	RNA
hdeAB-yhiD	GENE
hdeAB-yhiD_mRNA	RNA
indole	SIMPLE_MOLECULE	INDOLE
menaquinol	SIMPLE_MOLECULE	|Menaquinols|
phosphate	SIMPLE_MOLECULE
pyruvate	SIMPLE_MOLECULE	PYRUVATE
sulfide	SIMPLE_MOLECULE	HS
tnaC	GENE
tnaCAB	GENE
tnaCAB_mRNA	RNA
tnaC_mRNA	RNA
torCAD	GENE
torCAD_mRNA	RNA
torR	GENE
torR_mRNA	RNA
tryptophan	SIMPLE_MOLECULE	TRP
tryptophan_Ext	SIMPLE_MOLECULE	TRP_Ext
vitamin K2	SIMPLE_MOLECULE	|Menaquinones|
