7-aminomethyl-7-deazaguanosine34 in tRNA	SIMPLE_MOLECULE	|tRNA-with-7-aminomethyl-7-deazaguanine|
A(H2)	SIMPLE_MOLECULE	|Donor-H2|
PWY-6700	PROTEIN
QueA	PROTEIN	EG10812-MONOMER
QueF	PROTEIN	G7452-MONOMER
QueG	PROTEIN	G7843-MONOMER
SAM	SIMPLE_MOLECULE	S-ADENOSYLMETHIONINE
Tgt	PROTEIN	EG10996-MONOMER
acceptors	SIMPLE_MOLECULE	|Acceptor|
adenine	SIMPLE_MOLECULE	ADENINE
epoxyqueuosine34 in tRNA	SIMPLE_MOLECULE	|tRNAs-containing-epoxy-quenosine|
guanine	SIMPLE_MOLECULE	GUANINE
guanine34 in tRNA	SIMPLE_MOLECULE	|Guanine34-in-tRNAs|
methionine	SIMPLE_MOLECULE	MET
preQ0	SIMPLE_MOLECULE	7-CYANO-7-DEAZAGUANINE
preQ1	SIMPLE_MOLECULE	7-AMINOMETHYL-7-DEAZAGUANINE
queA	GENE
queA_mRNA	RNA
queF	GENE
queF_mRNA	RNA
queG	GENE
queG_mRNA	RNA
tRNA containing queuosine	SIMPLE_MOLECULE	|tRNAs-with-queuine|
tgt	GENE
tgt_mRNA	RNA
