5'-IMP	SIMPLE_MOLECULE	IMP
5'-UMP	SIMPLE_MOLECULE	UMP
MazE	PROTEIN	EG10571-MONOMER
MazE-MazF	PROTEIN
MazF	PROTEIN	EG11249-MONOMER
MazF-MazE	COMPLEX	CPLX0-1242
MazG	PROTEIN	EG10572-MONOMER
cytidine-triphosphate	SIMPLE_MOLECULE	CTP
cytidylate	SIMPLE_MOLECULE	CMP
dAMP	SIMPLE_MOLECULE	DAMP
dATP	SIMPLE_MOLECULE	DATP
dCMP	SIMPLE_MOLECULE	DCMP
dCTP	SIMPLE_MOLECULE	DCTP
dGMP	SIMPLE_MOLECULE	DGMP
dGTP	SIMPLE_MOLECULE	DGTP
dIMP	SIMPLE_MOLECULE	DIMP
dITP	SIMPLE_MOLECULE	DITP
dTMP	SIMPLE_MOLECULE	TMP
dTTP	SIMPLE_MOLECULE	TTP
dUMP	SIMPLE_MOLECULE	DUMP
dUTP	SIMPLE_MOLECULE	DUTP
diphosphate	SIMPLE_MOLECULE	PPI
inosine triphosphate	SIMPLE_MOLECULE	ITP
mazEFG	GENE
mazEFG_mRNA	RNA
mononucleotide	SIMPLE_MOLECULE	|Nucleoside-Monophosphates|
nucleoside triphosphate	SIMPLE_MOLECULE	|Nucleoside-Triphosphates|
uridine-triphosphate	SIMPLE_MOLECULE	UTP
xanthosine 5' triphosphate	SIMPLE_MOLECULE	XTP
xanthosine-5-P	SIMPLE_MOLECULE	XANTHOSINE-5-PHOSPHATE
