2-P-D-glycerate	SIMPLE_MOLECULE	2-PG
AllA	PROTEIN	G6275-MONOMER
AllB	PROTEIN	G6281-MONOMER
AllR	PROTEIN
AllR-allantoin	COMPLEX
AllR-glyoxylate	COMPLEX
AllS	PROTEIN	G6274-MONOMER
CO2	SIMPLE_MOLECULE	CARBON-DIOXIDE
Gcl	PROTEIN	GLYOCARBOLIG-MONOMER
GlxK	PROTEIN	GLY3KIN-MONOMER
GlxR	PROTEIN	G6278-MONOMER
Hyi	PROTEIN	G6277-MONOMER
OH-pyr	SIMPLE_MOLECULE	OH-PYR
YbbW	PROTEIN	B0511-MONOMER
YbbY	PROTEIN	G6282-MONOMER
allA	GENE
allA_mRNA	RNA
allS	GENE
allS_mRNA	RNA
allantoate	SIMPLE_MOLECULE	ALLANTOATE
allantoin	SIMPLE_MOLECULE
allantoin	SIMPLE_MOLECULE	S-ALLANTOIN
gcl-hyi-glxR-ybbW-allB-ybbY-glxK	GENE
gcl-hyi-glxR-ybbW-allB-ybbY-glxK_mRNA	RNA
glycerate	SIMPLE_MOLECULE	GLYCERATE
glyoxylate	SIMPLE_MOLECULE
glyoxylate	SIMPLE_MOLECULE	GLYOX
tartronate-S-ald	SIMPLE_MOLECULE	TARTRONATE-S-ALD
urea	SIMPLE_MOLECULE	UREA
ureidoglycolate	SIMPLE_MOLECULE	CPD-1091
