6-carboxytetrahydropterin	SIMPLE_MOLECULE	CPD0-1699
7-carboxy-7-deazaguanine	SIMPLE_MOLECULE	CPD-13043
FolE	PROTEIN	GTP-CYCLOHYDRO-I-MONOMER
H2NTP	SIMPLE_MOLECULE	DIHYDRONEOPTERIN-P3
P3,i	SIMPLE_MOLECULE	P3I
PWY-6703	PROTEIN
QueC	PROTEIN	G6245-MONOMER
QueD	PROTEIN	G7431-MONOMER
ammonium	SIMPLE_MOLECULE	AMMONIUM
ethanal	SIMPLE_MOLECULE	ACETALD
folE	GENE
folE_mRNA	RNA
formate	SIMPLE_MOLECULE	FORMATE
guanosine-triphosphate	SIMPLE_MOLECULE	GTP
phosphate	SIMPLE_MOLECULE	|Pi|
preQ0	SIMPLE_MOLECULE	7-CYANO-7-DEAZAGUANINE
queC	GENE
queC_mRNA	RNA
queD	GENE
queD_mRNA	RNA
