ADP-D-beta-D-heptose	SIMPLE_MOLECULE	ADP-D-GLYCERO-D-MANNO-HEPTOSE
ADP-L-glycero-D-manno-heptose	SIMPLE_MOLECULE	ADP-L-GLYCERO-D-MANNO-HEPTOSE
GmhB	PROTEIN	EG11736-MONOMER
LpcA	PROTEIN	G6106-MONOMER
PWY0-1241	PROTEIN
RfaD	PROTEIN	EG10838-MONOMER
RfaE	PROTEIN	G7590-MONOMER
beta-D-heptose-1,7-bisphosphate	SIMPLE_MOLECULE	D-BETA-D-HEPTOSE-17-DIPHOSPHATE
beta-D-heptose-1-phosphate	SIMPLE_MOLECULE	D-BETA-D-HEPTOSE-1-P
diphosphate	SIMPLE_MOLECULE	PPI
glycero-D-heptose 7-P	SIMPLE_MOLECULE	D-ALPHABETA-D-HEPTOSE-7-PHOSPHATE
gmhB	GENE
gmhB_mRNA	RNA
lpcA	GENE
lpcA_mRNA	RNA
phosphate	SIMPLE_MOLECULE	|Pi|
rfaD	GENE
rfaD_mRNA	RNA
rfaE	GENE
rfaE_mRNA	RNA
sedoheptulose-7-P	SIMPLE_MOLECULE	D-SEDOHEPTULOSE-7-P
