(2Z)-2-aminobut-2-enoate	SIMPLE_MOLECULE	CPD-15056
2-oxobutyrate	SIMPLE_MOLECULE	2-OXOBUTANOATE
3',5'-ADP	SIMPLE_MOLECULE	3-5-ADP
CydA	PROTEIN	CYDA-MONOMER
CydA-CydB-CydX	COMPLEX	CYT-D-UBIOX-CPLX
CydB	PROTEIN	CYDB-MONOMER
CydX	PROTEIN	MONOMER0-2663
CysH	PROTEIN	PAPSSULFOTRANS-MONOMER
HypT-Met-oxidized	PROTEIN
MetB	PROTEIN	O-SUCCHOMOSERLYASE-MONOMER
MetI	PROTEIN	METI-MONOMER
MetL	PROTEIN	ASPKINIIHOMOSERDEHYDROGII-MONOMER
MetN	PROTEIN	ABC-MONOMER
MetN-MetI-MetQ	COMPLEX	METNIQ-METHIONINE-ABC-CPLX
MetQ	PROTEIN	METQ-MONOMER
Methionine S-oxide	SIMPLE_MOLECULE	|L-Methionine-sulfoxides|
Methionine S-oxide_Ext	SIMPLE_MOLECULE	|L-Methionine-sulfoxides|_Ext
PAPS	SIMPLE_MOLECULE	PAPS
acetyl-DL-methionine	SIMPLE_MOLECULE	CPD-3738
acetyl-DL-methionine_Ext	SIMPLE_MOLECULE	CPD-3738_Ext
ammonium	SIMPLE_MOLECULE	AMMONIUM
aspartate	SIMPLE_MOLECULE	L-ASPARTATE
aspartate-semialdehyde	SIMPLE_MOLECULE	L-ASPARTATE-SEMIALDEHYDE
aspartyl-4-P	SIMPLE_MOLECULE	L-BETA-ASPARTYL-P
cydA	GENE
cydA_mRNA	RNA
cydB	GENE
cydB_mRNA	RNA
cysH	GENE
cysH_mRNA	RNA
cystathionine	SIMPLE_MOLECULE	L-CYSTATHIONINE
cysteine	SIMPLE_MOLECULE	CYS
homo-ser	SIMPLE_MOLECULE	HOMO-SER
metB	GENE
metB_mRNA	RNA
metI	GENE
metI_mRNA	RNA
metL	GENE
metL_mRNA	RNA
metN	GENE
metN_mRNA	RNA
metQ	GENE
metQ_mRNA	RNA
methionine	SIMPLE_MOLECULE	MET
methionine-(S)-S-oxide	SIMPLE_MOLECULE	CPD-8989
methionine-(S)-S-oxide_Ext	SIMPLE_MOLECULE	CPD-8989_Ext
methionine-R-sulfoxide	SIMPLE_MOLECULE	CPD-8990
methionine-R-sulfoxide_Ext	SIMPLE_MOLECULE	CPD-8990_Ext
methionine_Ext	SIMPLE_MOLECULE	MET_Ext
oxygen_Ext	SIMPLE_MOLECULE	OXYGEN-MOLECULE_Ext
pos	PROTEIN
reduced thioredoxin	SIMPLE_MOLECULE	|Red-Thioredoxin|
succinate	SIMPLE_MOLECULE	SUC
succinyl-homoserine	SIMPLE_MOLECULE	O-SUCCINYL-L-HOMOSERINE
sulfite	SIMPLE_MOLECULE	SO3
thioredoxin disulfide	SIMPLE_MOLECULE	|Ox-Thioredoxin|
ubiquinol_Ext	SIMPLE_MOLECULE	|Ubiquinols|_Ext
ubiquinone	SIMPLE_MOLECULE	|Ubiquinones|
