(R)-2,3-dihydroxy-3-methylvalerate	SIMPLE_MOLECULE	1-KETO-2-METHYLVALERATE
(R)-2,3-dihydroxy-isovalerate	SIMPLE_MOLECULE	CPD-13357
(S)-2-aceto-2-hydroxybutanoate	SIMPLE_MOLECULE	2-ACETO-2-HYDROXY-BUTYRATE
2-ketovaline	SIMPLE_MOLECULE	2-KETO-ISOVALERATE
4'-P-Pantothenate	SIMPLE_MOLECULE	4-P-PANTOTHENATE
CoaA	PROTEIN	PANTOTHENATE-KIN-MONOMER
IlvC	PROTEIN	KETOLREDUCTOISOM-MONOMER
PANTO-PWY	PROTEIN
PanB	PROTEIN	3-CH3-2-OXOBUTANOATE-OH-CH3-XFER-MONOMER
PanC	PROTEIN	PANTOATE-BETA-ALANINE-LIG-MONOMER
PanE	PROTEIN	2-DEHYDROPANTOATE-REDUCT-MONOMER
THF polyglutamate	SIMPLE_MOLECULE	THF-GLU-N
alpha-acetolactate	SIMPLE_MOLECULE	2-ACETO-LACTATE
beta-alanine	SIMPLE_MOLECULE	B-ALANINE
coaA	GENE
coaA_mRNA	RNA
diphosphate	SIMPLE_MOLECULE	PPI
ilvC	GENE
ilvC_mRNA	RNA
ketopantoate	SIMPLE_MOLECULE	2-DEHYDROPANTOATE
methylene-H4PteGlu(n)	SIMPLE_MOLECULE	METHYLENE-THF-GLU-N
panB	GENE
panB_mRNA	RNA
panC	GENE
panC_mRNA	RNA
panE	GENE
panE_mRNA	RNA
pantoate	SIMPLE_MOLECULE	L-PANTOATE
pantothenic acid	SIMPLE_MOLECULE	PANTOTHENATE
