2-carboxymuconate	SIMPLE_MOLECULE	2-CARBOXYMUCONATE
2-pyrocatechuate	SIMPLE_MOLECULE	2-3-DIHYDROXYBENZOATE
3',8-cH2GTP	SIMPLE_MOLECULE	CPD-19179
5'-deoxyadenosine	SIMPLE_MOLECULE	CH33ADO
A(H2)	SIMPLE_MOLECULE	|Donor-H2|
CopA	PROTEIN	MONOMER0-4382
Cu(I)	SIMPLE_MOLECULE	CU+
Cu(I)_Ext	SIMPLE_MOLECULE	CU+_Ext
Cu(II)	SIMPLE_MOLECULE	CU+2
CueO	PROTEIN	EG12318-MONOMER
CueR-Cu	PROTEIN
DMP	SIMPLE_MOLECULE	CPD-12797
Fe+2	SIMPLE_MOLECULE	FE+2
H2Dtpp-mP	SIMPLE_MOLECULE	CPD-4
MPT-Synthase-small-subunits	SIMPLE_MOLECULE	|MPT-Synthase-small-subunits|
MoaA	PROTEIN	EG11595-MONOMER
MoaB	PROTEIN	MONOMER0-1501
MoaC	PROTEIN	EG11666-MONOMER
MoaD	PROTEIN	EG11597-MONOMER
MoaD-MoaE	COMPLEX	CPLX0-2502
MoaE	PROTEIN	EG11598-MONOMER
SAM	SIMPLE_MOLECULE	S-ADENOSYLMETHIONINE
TMPQ	SIMPLE_MOLECULE	CPD-19233
acceptors	SIMPLE_MOLECULE	|Acceptor|
cPMP	SIMPLE_MOLECULE	PRECURSOR-Z
copA	GENE
copA_mRNA	RNA
cueO	GENE
cueO_mRNA	RNA
diphosphate	SIMPLE_MOLECULE	PPI
fe(iii)	SIMPLE_MOLECULE	FE+3
guanosine-triphosphate	SIMPLE_MOLECULE	GTP
methionine	SIMPLE_MOLECULE	MET
moaA	GENE
moaA_mRNA	RNA
moaB	GENE
moaB_mRNA	RNA
moaC	GENE
moaC_mRNA	RNA
moaD	GENE
moaD_mRNA	RNA
moaE	GENE
moaE_mRNA	RNA
oxygen	SIMPLE_MOLECULE	OXYGEN-MOLECULE
thiocarboxylated small subunit of molybdopterin synthase	SIMPLE_MOLECULE	|Thiocarboxylated-MPT-synthases|
