3-keto-L-gulonate 6-P	SIMPLE_MOLECULE	CPD-2343
CO2	SIMPLE_MOLECULE	CARBON-DIOXIDE
HPr - phosphorylated_Ext	SIMPLE_MOLECULE	PTSH-PHOSPHORYLATED_Ext
PtsH	SIMPLE_MOLECULE	PTSH-MONOMER
UlaA	PROTEIN	SGAT-MONOMER
UlaB	PROTEIN	YJFT-MONOMER
UlaC	PROTEIN	YJFU-MONOMER
UlaC-UlaB-UlaA	COMPLEX	EIISGA
UlaD	PROTEIN	G7858-MONOMER
UlaE	PROTEIN	G7859-MONOMER
UlaF	PROTEIN	G7860-MONOMER
UlaG	PROTEIN	G7855-MONOMER
UlaR	PROTEIN
UlaR-ascorbate 6-phosphate	COMPLEX
ascorbate 6-phosphate	SIMPLE_MOLECULE
ascorbate 6-phosphate	SIMPLE_MOLECULE	L-ASCORBATE-6-PHOSPHATE
ascorbate_Ext	SIMPLE_MOLECULE	ASCORBATE_Ext
ribulose-5-P	SIMPLE_MOLECULE	L-RIBULOSE-5-P
ulaABCDEF	GENE
ulaABCDEF_mRNA	RNA
ulaG	GENE
ulaG_mRNA	RNA
xylulose 5P	SIMPLE_MOLECULE	L-XYLULOSE-5-P
xylulose-P	SIMPLE_MOLECULE	XYLULOSE-5-PHOSPHATE
