ASPARAGINE-DEG1-PWY	PROTEIN
AnsA	PROTEIN	ANSA-MONOMER
AnsB	PROTEIN	ANSB-MONOMER
AnsI	PROTEIN	ANSA-CPLX
AsnII	PROTEIN	ANSB-CPLX
IaaA	PROTEIN	EG12407-MONOMER
IaaA	PROTEIN	MONOMER0-2
IaaA	PROTEIN	MONOMER0-3
IaaA-IaaA	COMPLEX	CPLX0-263
amino acids	SIMPLE_MOLECULE	|Amino-Acids-20|
ammonium	SIMPLE_MOLECULE	AMMONIUM
ansA	GENE
ansA_mRNA	RNA
ansB	GENE
ansB_mRNA	RNA
asparagine	SIMPLE_MOLECULE	ASN
aspartate	SIMPLE_MOLECULE	L-ASPARTATE
beta-aspartyl dipeptide	SIMPLE_MOLECULE	CPD-12991
iaaA	GENE
iaaA_mRNA	RNA
