PWY0-901	PROTEIN
SERYL-TRNA(SER)	SIMPLE_MOLECULE	|Charged-SER-tRNAs|
SelA	PROTEIN	EG10941-MONOMER
SelB	PROTEIN	CPLX0-8053
SelD	PROTEIN	EG10943-MONOMER
SerS	PROTEIN	SERS-MONOMER
TRNA(SER)	SIMPLE_MOLECULE	|SER-tRNAs|
charged-selC-tRNA	PROTEIN	|charged-selC-tRNA|
diphosphate	SIMPLE_MOLECULE	PPI
modified-charged-selC-tRNA	PROTEIN	|modified-charged-selC-tRNA|
phosphate	SIMPLE_MOLECULE	|Pi|
selA	GENE
selA_mRNA	RNA
selC	GENE
selC-tRNA	PROTEIN	|selC-tRNA|
selC_mRNA	RNA
selD	GENE
selD_mRNA	RNA
selenide	SIMPLE_MOLECULE	SE-2
selenocysteinyl-tRNA(ser)	SIMPLE_MOLECULE	|Charged-SEC-tRNAs|
selenophosphate	SIMPLE_MOLECULE	SEPO3
serS	GENE
serS_mRNA	RNA
serine	SIMPLE_MOLECULE	SER
seryl-tRNAsec	SIMPLE_MOLECULE	|L-seryl-SEC-tRNAs|
tRNAsec	SIMPLE_MOLECULE	|tRNA-Sec|
