AgaA	PROTEIN	AGAA-MONOMER
AgaB	PROTEIN	AGAB-MONOMER
AgaB-AgaC-AgaD	COMPLEX	CPLX-170
AgaC	PROTEIN	AGAC-MONOMER
AgaD	PROTEIN	AGAD-MONOMER
AgaI	PROTEIN	G7636-MONOMER
AgaR	PROTEIN	G7630-MONOMER
AgaS	PROTEIN	G7634-MONOMER
AgaV	PROTEIN	G7632-MONOMER
AgaV-AgaW	COMPLEX	CPLX0-7610
AgaW	PROTEIN	G7633-MONOMER
DHAP	SIMPLE_MOLECULE	DIHYDROXY-ACETONE-PHOSPHATE
KbaY	PROTEIN	TAGAALDOL1-MONOMER
KbaY-KbaZ	COMPLEX	CPLX0-240
KbaZ	PROTEIN	G7631-MONOMER
agaA	GENE
agaA_mRNA	RNA
agaB	GENE
agaB_mRNA	RNA
agaC	GENE
agaC_mRNA	RNA
agaD	GENE
agaD_mRNA	RNA
agaI	GENE
agaI_mRNA	RNA
agaR	GENE
agaR_mRNA	RNA
agaS	GENE
agaS_mRNA	RNA
agaV	GENE
agaV_mRNA	RNA
agaW	GENE
agaW_mRNA	RNA
glyceraldehyde-P	SIMPLE_MOLECULE	GAP
kbaY	GENE
kbaY_mRNA	RNA
kbaZ	GENE
kbaZ_mRNA	RNA
tagatofuranose 1,6-diphosphate	SIMPLE_MOLECULE	TAGATOSE-1-6-DIPHOSPHATE
