AcrA	PROTEIN	EG11703-MONOMER
AcrD	PROTEIN	ACRD-MONOMER
AcrD-AcrA-TolC	COMPLEX	CPLX0-3932
BaeR	PROTEIN	BAER-MONOMER
BaeS	PROTEIN	BAES-MONOMER
MdtA	PROTEIN	MDTA
MdtB	PROTEIN	B2075-MONOMER
MdtC	PROTEIN	B2076-MONOMER
MdtD	PROTEIN	B2077-MONOMER
Spy	PROTEIN	G6939-MONOMER
TolC	PROTEIN	EG11009-MONOMER
TolC-MdtC-MdtB-MdtA	COMPLEX	TRANS-CPLX-202
acrD	GENE
acrD_mRNA	RNA
baeR	GENE
baeR_mRNA	RNA
baeS	GENE
baeS_mRNA	RNA
deoxycholate	SIMPLE_MOLECULE	DEOXYCHOLATE
deoxycholate_Ext	SIMPLE_MOLECULE	DEOXYCHOLATE_Ext
drug	SIMPLE_MOLECULE	|Drugs|
drug_Ext	SIMPLE_MOLECULE	|Drugs|_Ext
mdtA	GENE
mdtA_mRNA	RNA
mdtB	GENE
mdtB_mRNA	RNA
mdtC	GENE
mdtC_mRNA	RNA
mdtD	GENE
mdtD_mRNA	RNA
novobiocin	SIMPLE_MOLECULE	CPD-15417
novobiocin_Ext	SIMPLE_MOLECULE	CPD-15417_Ext
pos	PROTEIN
spy	GENE
spy_mRNA	RNA
